1111111111111111111111111111
1000000000E0000000000P000001
1M11110000000000000111100001
1010010000000000000100100001
1000000M0000C0000C0000000001
1000000000C00000000000000001
1111111111111111111111111111