11111111111111111111111111111111111111
100CM0000001P0000000000000000000000001
10000000000100000000000000000000000001
10000000000000000000000000000000000001
1000000000000000M00000000100000M000001
10000E000000M0000000000001000000000001
10000000000000000000000001000000000001
1CCC00000000000C0000000001000000000001
1000000000000000000000000100000M000001
11111100000000000001111111111111111111
10000000000000000000000000000000000001
1000000C000000M00000000000000000000001
10000000000000000000000000000000000001
10000000000000M000C0000000000000000001
10000000000000000000000000000000000001
10000000000000000000000000000000000001
11111111111111111111111111111111111111