1111111111111111111111111
10000000M00000M0000000001
1000000000000000000000001
10C0100000000000000000001
100000000P001111111111111
1000000000001000000000001
1000E00000001000000CM0001
1000000000000001111111111
1111111111111111111111111