NO srcs/textures/Wall2.xpm
SO srcs/textures/Wall3.xpm
WE srcs/textures/Wall1.xpm
EA srcs/textures/new_tuyaux.xpm

F 220,100,0
C 225,30,0

        1111111111111111111111111
        100000000011000000W000001
        1011000001110000000000001
        1001000000000000000000001
111111111011000001110000000000001
100000000011000001110000000111111111
11110011111111011100000010001
11110011111111011101010010001
11000000110101011100000010001
10000000000000001100000010001
10000000000000000001010010001
1100000111010101111101111000111
1111011111010100001111010001
111111111100011100000111100111
        1110001111111111100111111
        1000000000110000000000001
        1011000001110000000000001
        1001000000000000000000001
111111111011000001110000000000001
100000000011000001110111100111111
11110111111111011100000010001
11110011111111011101010010001
11000000110101011100000000001
10000000000000000000000000001
10000000000000000001000000001
11000000010101011111000000N0111
111100000111010111100000000001
1111000001110001111000000000011
10000000000000000000000000001
10000000000000000000000000001
10000000000000000000000000001
10000000000000000000000000001
10000000000000000000000000001
111111000000000000000000000011111111111111
100000000000000000000000000000000000000001
100000000000000000000000000000000000000001
100000000000000000000000100000000000000001
111111111111111111111111111110000000000001
                            11000000010001
                            10000000000001
                            100000000000011111111111            111111
                            100000000000010000000001            100001
                            100000000000000000000001            100001
                            110000000000000000000001            100001
1111111111111111111111111111100000000000000000000001111111111111100001
1000000000000000000000001000100000000000000000000000000000000000000001
1000000000000000000000000000000000000000000000000000000000000000000001
1000000000000000000000001000100000000000010000000000000000000000000001
1111111111111111111111111111100000000000011000000000000000000000000001
                            100000000000011111111111111111111111110001
                            100000000000011111111111            110001
                            100000000000010000000001            100001
                            100000000000000000000001            100001
                            110000000000000000000001            100001
1111111111111111111111111111100000000000000000000001111111111111100001
1000000000000000000000001000100000000000000000000000000000000000000001
1000000000000000000000000000000000000000000000000000000000000000000001
1000000000000000000000001000100000000000010000000000000000000000000001
1111111111111111111111111111100000000000011000000000000000000000000001
                            111111111111111111111111111111111111111111